14 26
%%%%%%%%%%%%%%%%%%%%%%%%%%
%                       .%
%                        %
%                        %
%                        %
%                        %
%  %%%%%%%%%%%%%%%%%     %
%                  %     %
%                  %     %
%                  %     %
%                  %     %
%                  %     %
% P                      %
%%%%%%%%%%%%%%%%%%%%%%%%%%